########################################################
#A       #       #   #   #       #       #       #     #
# ##### ### ##### # # # ### ##### ##### ### ### ### ###
# #   #       #   # # #           #   # #   #   #   # #
# # # ### ### # ### ##### ##### ### ### # # ### # ### #
#   #     #   #   #   #   #   #     #   # #     #     #
### ##### # ##### ### ### ### ### ##### ##### ####### #
#         #         #   #   #   # #   # #     #     # #
# ### ##### ##### ##### # ##### # ### # ### ### ##### #
# # # #   # #           #     # #   #   #     #   #   #
# # # ### ### ### ##### ##### ### # ### ### ##### ### #
# #     #     #   # #   #   #     #   #   # #   #   # #
##### ### ##### ### ### # ### ##### # ##### ### ### ###
#     #   #   # #     #       #     #     #     #     #
### ### ##### # ##### ### ### # ##### ##### ### ##### #
#   #       # #     #     #   #   #   #     # # #   # #
# ########### ### # ##### ### ### ### # ### # # ### ###
# #     #   #   # # # #   #   #   #   # # # # #     # #
# ### ### # ### ### # ### ##### ### ### # # # ####### #
# #   #   #   #   #     #     #   #   # # #     #   # #
# # ### ##### ### ### ### ##### ##### ### ##### ### ###
# #   #       #   #     #     #     #     #   #   #   #
### ########### ### ### # ### ##### ### ### ### ### ###
#       #   #     #   # #     #   #   #   #   #   #   #
# ##### ### ##### # ##### ### # ##### # ##### ##### ###
#   #     #       #       #   #     # #   #   #       #
### ### ##### ##################### # ### ### ### #####
#   #   #       #       #         # #   #   #     #   #
# ##### ##### # ### ### # ##### ### ##### ### ### ### #
#     #     # #   #   # #   #   #   #   #   # #   # # #
##### ##### # ### ### ### ### ##### ### # ### # ### # #
#   # #     # # #   #     #     # #   # #   # #     # #
# ### # ### ### ### ### ##### ### ### # ### # ##### ###
# #   #   #   #     #   #   # #     # #   # #     #   #
# ##### # ### # ##### ##### # ##### # # ### ### ##### #
# #     # #   # #       #   #     # #   #     #     # #
# # ##### ### ### ### ### ##### ### ##### ##### ##### #
# # #   # #   #   #   #     #     # #     #         # #
# # # ### ### ### ##### ### # ### # # ##### ### ### ###
# # #   #     # #     #   # # #   #         #   #   # #
# # ### ### ### ### ### ### ### ### ### ##### ### ### #
#   #     #   #     #   #   # #     # #   #   # #     #
##### ### ### ### ### ### # # ##### # ##### ### ##### #
#       #   #   #     #   # #     #   #     #       #B#
########################################################
