############################################################################################################################
#A                       #       #       #       #     #   #       #   #   #       #       #       #     #       #       #
# ##### ### ##### # # # ### ##### ##### ### ### ### ### ### ##### # # ### ### ##### ##### ### ##### ##### ##### ### ### ###
# #   #       #   # # #           #   #     #   #   #   #       #   #   #       #   #   # #   #   # #       #     #     # #
# # # ### ### # ### ##### ##### ### ### # # ### # ### ### ##### ### ##### ##### ### # ### ##### # # ### # ### # ### ### # #
#   #     #   #   #   #   #   #     #   # #     #     # #   #   #     #   #   #   #   #   #     #   # # # #   #     # # # #
### ##### # ##### ### ### ### ### ##### ##### ####### # ### # ##### ### ### ##### ##### ### ##### ### ##### ##### ##### ###
#         #         #   #   #   #     # #           #   #   #       # #     #     #     #   #       #     #   # #   #     #
# ### ##### ##### ##### # ##### # ### # ### ### ##### ### ### ### ### ##### # ##### ##### # ##### ##### ### ### # # ##### #
# # # #   # #           #     # #   #   #     #   #   # #   #   # #       # #     #   # # #   #     # #   #     #     #   #
# # # ### ### ### ##### ##### ### # ### ### ##### ### ### ### ### ##### # # ##### # ### # ##### ##### # ##### ### # ### ###
# #     #     #   # #   #   #     #   #   # #   #   # #   # # #     #   #   #   # #         # #       #   #     #   #     #
##### ### ##### ### ### # ### ##### # ##### ### ### ### ### ### ### ### ##### ### ### ##### ### ### ##### ### ### ##### ###
#     #   #   # #     #       #     #     #     #           #     # #       #     #   #   #   #   #     #     #     #     #
### ### ##### # ##### ### ### # ##### ##### ### ##### ##### ### ### ##### ##### ### ### ### ##### ### ### ### ##### ##### #
#   #       # #     #     #   #   #   #     # # # #   #   #   # #     #   #   #   #   #   #   #   #   # #   #     #   #   #
# ########### ### # ##### ### ### ### # ### # # ### ### ### ### ##### ### ##### ### ### ##### # ### ##### ### ##### ### ###
# #     #   #   # # # #   #   #   #   # # # # #     #   # # #     #     #     # # # # #     # #   #     # #     # # #     #
# ### ### # ### ### # ### ##### ### ### # # # ####### ### # ### ### ### ##### ### # # ##### # ### # ##### ### ##### # ### #
# #   #   #   #   #     #     #   #   # # #     #   #   #   #   #   #       #   #   #   #   #   # # # #   #     #   # #   #
# # ### ##### ### ### ### ##### ##### ### ##### ### # ### ### ### ### ### # ##### ### ### ##### ### # ### ##### ##### ### #
# #   #       #   #     #     #     #     #   #   # #     #     #   #   # #   #   #     #   #   #   #     #   # #   #     #
### ########### ### ### # ### ##### ### ### ### ### ##### ### ##### # ##### ### ### ##### ### ##### ### ### ### ##### ### #
#       #   #     #   # #     #   #   #   #   #   #   #   #   #   # #     #       #   #   #   # #   #     #   #       #   #
# ##### ### ##### # ##### ### # ##### # ##### ##### ### ##### ### ### ##### ##### ##### ### ### ### ##### ##### ### ##### #
#   #     #       #       #   #     # #   #   #       #       #   #     #   #   #     #   #     #       #     # #   #   # #
### ### ##### ##################### # ### ### ### ### ##### ##### ### ### ##### ##### ### ### ####### ### ### # ##### ### #
#   #   #       #       #         # #   #   #     #   #     #     #   #       #   #       #   #     #     #   #     #     #
# ##### ##### # ### ### # ##### ### ##### ### ### ##### ### ##### ##### ### ##### ### ### ### ### ### # ### ### ### ##### #
#     #     # #   #   # #   #   #   #   #   # # #   #   #     #   #     #   #   # #     #   #   #     #     #     #       #
##### ##### # ### ### ### ### ##### ### # ### # ### # ##### ### ##### ### ### ### ### ##### ### ### ### ### ##### ####### #
#   # #     # # #   #     #     # #   # #   # #   # #     # #     #     #     #   #     #     #   # # # #   # #           #
# ### # ### ### ### ### ##### ### ### # ### # ##### ##### ##### ##### # ### ### ##### ### ##### ### # # # ### # ##### ### #
# #   #   #   #     #   #   # #     # #   # # #       #   #   #     # #   #     #     # #   # #   #     #     # # #   #   #
# ##### # ### # ##### ##### # ##### # # ### ### ##### ### ### ##### # # ##### ##### ### ### # ### ### ##### ### # ##### ###
# #     # #   # #       #   #     # #   #     #   #     #   #     #   #     #   #   #   #     #     #   # #       #   #   #
# # ##### ### ### ### ### ##### ### ##### ##### # ##### ### ### ### ### ### ##### ##### ### ##### ### ### ### ##### ##### #
# # #   # #   #   #   #     #     # #     #         #   #   #   #     #     #       #     #   # #   #     #     #       # #
# # # ### ### ### ##### ### # ### # # ##### ### ### ### # ### ##### ##### ##### ### ### ### ### ### # ##### ### ### ##### #
# # #   #     # #     #   # # #   #         #   #   # # #   #     # # #   #   #   #   #     #     # #   # #   #     #     #
# # ### ### ### ### ### ### ### ### ### ##### ### ### ### ### ### ### # ### ##### ### ##### ### ### ### # ### ### ##### ###
#   #     #   #     #   #   # #     # #   #   # #     # #     #     #   #   #   #   #   #   #   # #   #   # #     #       #
##### ### ### ### ### ### ### # # ##### ### ##### ### # ##### ##### ##### ### # # ##### # ### ### ### ##### ##### ### ### #
#       #   #   #     #   #   # #     #   #     #       #     #   #   #   # # #   #   # #     #     #   #   #     #   #B  #
############################################################################################################################
