################################
#A     #       #        #      #
# ##### ##### ### ### # ##### ##
#             #   # # #   #    #
##### ### ### ### # # ### ######
#     #   # #     # #          #
### ### # # # ##### ### ### ####
# #   # # # #     #     #     #
# # ### # # ##### # ### # ### #
# # #   #   #   # #   # # #   #
# # # ##### ### # ##### # ### #
#   #   #       #       # #   #
##### # # ####### ####### # ###
#     # # #     # #       #   #
### ### # # ### # # ####### ###
#   #   # #   # #       #     #
# ### # ### ### ####### ##### #
#     #       #           #   B
################################
